#######################################
# Syntax Coloring Map For OneSheeld
#######################################

#######################################
# Datatypes (KEYWORD1)
#######################################
AccelerometerSensor	KEYWORD1
Buzzer	KEYWORD1
Camera	KEYWORD1
Email	KEYWORD1
Facebook	KEYWORD1
FlashLight	KEYWORD1
Foursquare	KEYWORD1
GamePad	KEYWORD1
GPS	KEYWORD1
GravitySensor	KEYWORD1
GyroscopeSensor	KEYWORD1
Keypad	KEYWORD1
LCD	KEYWORD1
LED	KEYWORD1
LightSensor	KEYWORD1
MagnetometerSensor	KEYWORD1
Mic	KEYWORD1
MusicPlayer	KEYWORD1
Notification	KEYWORD1
OneSheeld	KEYWORD1
OrientationSensor	KEYWORD1
Phone	KEYWORD1
PressureSensor	KEYWORD1
ProximitySensor	KEYWORD1
PushButton	KEYWORD1
SevenSegment	KEYWORD1
Skype	KEYWORD1
Slider	KEYWORD1
SMS	KEYWORD1
TemperatureSensor	KEYWORD1
ToggleButton	KEYWORD1
Twitter	KEYWORD1
Clock	KEYWORD1
PulseWidthModulation	KEYWORD1
AsciiKeyboard	KEYWORD1
TextToSpeech	KEYWORD1
VoiceRecognition	KEYWORD1
Logger	KEYWORD1
Terminal	KEYWORD1
Pattern	KEYWORD1
Internet	KEYWORD1
ColorDetector	KEYWORD1
NFC	KEYWORD1
GLCD	KEYWORD1
#######################################
# Methods and Functions (KEYWORD2)
#######################################
open	KEYWORD2
getX	KEYWORD2
getY	KEYWORD2
getZ	KEYWORD2
buzzOn	KEYWORD2
buzzOff	KEYWORD2
begin	KEYWORD2
rearCapture	KEYWORD2
setFlash	KEYWORD2
send	KEYWORD2
post	KEYWORD2
postLastPicutre	KEYWORD2
setLow	KEYWORD2
setHigh	KEYWORD2
setValue	KEYWORD2
checkIn	KEYWORD2
isUpPressed	KEYWORD2
isDownPressed	KEYWORD2
isLeftPressed	KEYWORD2
isRightPressed	KEYWORD2
isOrangePressed	KEYWORD2
isRedPressed	KEYWORD2
isGreenPressed	KEYWORD2
isBluePressed	KEYWORD2
getLatitude	KEYWORD2
getLongitude	KEYOWRD2
init	KEYWORD2
isRowPressed	KEYWORD2
isColumnPressed	KEYWROD2
setOnButtonChange	KEYWORD2
clear	KEYWORD2
home	KEYWORD2
noDisplay	KEYWORD2
display	KEYWORD2
noBlink	KEYWORD2
blink	KEYWORD2
noCursor	KEYWORD2
cursor	KEYWORD2
scrollDisplayLeft	KEYWORD2
scrollDisplayRight	KEYWORD2
leftToRight	KEYWORD2
rightToLeft	KEYWORD2
autoScroll	KEYWORD2
noAutoScroll	KEYWORD2
createChar	KEYWORD2
setCursor	KEYWORD2
getValue	KEYWORD2
stop	KEYWORD2
play	KEYWORD2
pause	KEYWORD2
previous	KEYWORD2
next	KEYWORD2
seekForward	KEYWORD2
seekBackward	KEYWORD2
notifyPhone	KEYWORD2
call	KEYWORD2
setNumber	KEYWORD2
videoCall	KEYWORD2
message	KEYWORD2
isInRange	KEYWORD2
getDistance	KEYWORD2
radian	KEYWORD2
isRinging	KEYWORD2
getNumber	KEYWORD2
getNumberAsString	KEYWORD2
getSms	KEYWORD2
getSmsAsString	KEYWORD2
isNewSms	KEYWORD2
frontCapture	KEYWORD2
getSeconds	KEYWORD2
getMinutes	KEYWORD2
getHours	KEYWORD2
getDay	KEYWORD2
getMonth	KEYWORD2
getYear	KEYWORD2
setVolume	KEYWORD2
isAnyRowPressed	KEYWORD2
isAnyColumnPressed	KEYWORD2
getCharacter	KEYWORD2
setOnValueChange	KEYWORD2
setQuality	KEYWORD2
getMagneticStrength	KEYWORD2
setOnCallStatusChange	KEYWORD2
setOnSmsReceive	KEYWORD2
setOnButtonStatusChange	KEYWORD2
isPressed	KEYWORD2
getUserName	KEYWORD2
getTweet	KEYWORD2
getTweetAsString	KEYWORD2
isNewTweet	KEYWORD2
getUserNameAsString	KEYWORD2
setDot	KEYWORD2
tweet	KEYWORD2
setOnNewTweet	KEYWORD2
getAsFahrenheit	KEYWORD2
say	KEYWORD2
startListening	KEYWORD2
getLastCommand	KEYWORD2
getCommandAsString	KEYWORD2
isNewCommandReceived	KEYWORD2
setOnNewCommand	KEYWORD2
log	KEYWORD2
setFileFormat	KEYWORD2
add	KEYWORD2
postPicture	KEYWORD2
postLastPicture	KEYWORD2
setOnError	KEYWORD2
start	KEYWORD2
getStatus	KEYOWRD2
getLastCommandLength	KEYWORD2
tweetLastPicture	KEYWORD2
setOnSelected	KEYWORD2
select	KEYWORD2
deselect	KEYWORD2
waitForAppConnection	KEYWORD2
attachLastPicture	KEYWORD2
isAppConnected	KEYWORD2
trackKeyword	KEYWORD2
untrackKeyword	KEYWORD2
getOnButtonStatusChange	KEYWORD2
getRow	KEYWORD2
getColumn	KEYWORD2
setUrl	KEYWORD2
addHeader	KEYWORD2
addParameters	KEYWORD2
addRawData	KEYWORD2
getId	KEYWORD2
getIdLength	KEYWORD2
deleteHeaders	KEYWORD2
deleteParameters	KEYWORD2
deleteCallBacks	KEYWORD2
setContentType	KEYWORD2
setParametersContentEncoding	KEYWORD2
ignoreResponse	KEYWORD2
isStarted	KEYWORD2
isFinished	KEYWORD2
setOnSuccess	KEYWORD2
setOnFailure	KEYWORD2
setOnStart	KEYWORD2
setOnFinish	KEYWORD2
getResponse	KEYWORD2
isSentFully	KEYWORD2
isDisposed	KEYWORD2
setOnNextResponseBytesUpdate	KEYWORD2
setOnJsonResponse	KEYWORD2
setOnJsonArrayLengthResponse	KEYWORD2
dispose	KEYWORD2
resetIndex	KEYWORD2
getNextBytes	KEYWORD2
getTheseBytes	KEYWORD2
getHeader	KEYWORD2
getStatusCode	KEYWORD2
getBytesCount	KEYWORD2
getTotalBytesCount	KEYWORD2
getCurrentIndex	KEYWORD2
getBytes	KEYWORD2
query	KEYWORD2
queryArrayLength	KEYWORD2
performGet	KEYWORD2
performPost	KEYWORD2
performPut	KEYWORD2
performDelete	KEYWORD2
cancelAllRequests	KEYWORD2
setBasicAuthentication	KEYWORD2
clearBasicAuthentication	KEYWORD2
setIntialResponseMaxBytesCount	KEYWORD2
processInput	KEYWORD2
isCallbacksInterruptsSet	KEYWORD2
enableCallbacksInterrupts	KEYWORD2
disableCallbacksInterrupts	KEYWORD2
getShieldId	KEYWORD2
getLastPattern	KEYWORD2
getLastPatternLength	KEYWORD2
isNewPatternReceived	KEYWORD2
setOnNewPattern	KEYWORD2
getLastCommandAsString	KEYWORD2
getRed	KEYWORD2
getGreen	KEYWORD2
getBlue	KEYWORD2
getHue	KEYWORD2
getSaturation	KEYWORD2
getBrightness	KEYWORD2
getLastColor	KEYWORD2
setOnNewColor	KEYWORD2
isNewColorReceived	KEYWORD2
setPalette	KEYWORD2
getLastTag	KEYWORD2
isNewTagScanned	KEYWORD2
setOnNewTagScanned	KEYWORD2
isEmpty	KEYWORD2
getId	KEYWORD2
getNumberOfRecords	KEYWORD2
getRecord	KEYWORD2
getSize	KEYWORD2
getMaxSize	KEYWORD2
setOnRecordTypeResponse	KEYWORD2
setOnRecordParsedDataResponse	KEYWORD2
setOnRecordDataResponse	KEYWORD2
isNull	KEYWORD2
getTypeCategory	KEYWORD2
getTypeLength	KEYWORD2
getDataLength	KEYWORD2
queryData	KEYWORD2
queryType	KEYWORD2
queryParsedData	KEYWORD2
setOnAppConnected	KEYWORD2
queryDateAndTime	KEYWORD2
enableFullOperation	KEYWORD2
enableNormalOperation	KEYWORD2
isFullOperation	KEYWORD2
finishedReading	KEYWORD2
setCalculationMode	KEYWORD2
setPatchSize	KEYWORD2
enableTagInterrupts	KEYWORD2
disableTagInterrupts	KEYWORD2
setRange	KEYWORD2
setRadius	KEYWORD2
setText	KEYWORD2
setStyle	KEYWORD2
setDimensions	KEYWORD2
setOnChange	KEYWORD2
isSelected	KEYWORD2
setFill	KEYWORD2
setGroup	KEYWORD2
draw	KEYWORD2
setFont	KEYWORD2
setSize	KEYWORD2
setPosition	KEYWORD2
setVisibility	KEYWORD2
setCoordinates	KEYWORD2
getGroupNumber	KEYWORD2
setOnNewShieldFrame	KEYWORD2
setOnNewSerialData	KEYWORD2
#######################################
# Strcutures and Classes (KEYWORD3)
#######################################
Color	KEYWORD3
JsonKeyChain	KEYWORD3
HttpRequest	KEYWORD3
HttpResponse	KEYWORD3
NFCTag	KEYWORD3
NFCRecord	KEYWORD3
PatternNode	KEYWORD3
GLCDAnalogGauge	KEYWORD3
GLCDButton	KEYWORD3
GLCDCheckBox	KEYWORD3
GLCDEllipse	KEYWORD3
GLCDLine	KEYWORD3
GLCDPoint	KEYWORD3
GLCDProgressBar	KEYWORD3
GLCDRadioButton	KEYWORD3
GLCDRectangle	KEYWORD3
GLCDSlider	KEYWORD3
GLCDTextBox	KEYWORD3
#######################################
# Constants And Literals (KEYWORD2)
#######################################
OFF	LITERAL2
AUTO	LITERAL2
ON	LITERAL2
RADIUS_OF_EARTH	LITERAL2
LOW_QUALITY	LITERAL2
MID_QUALITY	LITERAL2
HIGH_QUALITY	LITERAL2
NETWORK_TIMEOUT_ERROR	LITERAL2
NETWORK_ERROR	LITERAL2
AUDIO_ERROR	LITERAL2
SERVER_ERROR	LITERAL2
SPEECH_TIMEOUT_ERROR	LITERAL2
NO_MATCH_ERROR	LITERAL2
RECOGNIZER_BUSY_ERROR	LITERAL2
FROM_ONESHEELD_FOLDER	LITERAL2
FROM_CAMERA_FOLDER	LITERAL2
INDEX_OUT_OF_BOUNDS	LITERAL2					
RESPONSE_CAN_NOT_BE_FOUND	LITERAL2
HEADER_CAN_NOT_BE_FOUND	LITERAL2
NO_ENOUGH_BYTES	LITERAL2
REQUEST_HAS_NO_RESPONSE	LITERAL2
SIZE_OF_REQUEST_CAN_NOT_BE_ZERO	LITERAL2
UNSUPPORTED_HTTP_ENTITY	LITERAL2
JSON_KEYCHAIN_IS_WRONG	LITERAL2
REQUEST_CAN_NOT_BE_FOUND	LITERAL2
NOT_CONNECTED_TO_NETWORK	LITERAL2
URL_IS_NOT_FOUND	LITERAL2
ALREADY_EXECUTING_REQUEST	LITERAL2
URL_IS_WRONG	LITERAL2
INCLUDE_KEYPAD_SHIELD	LITERAL2
INCLUDE_GPS_SHIELD	LITERAL2
INCLUDE_SLIDER_SHIELD	LITERAL2
INCLUDE_PUSH_BUTTON_SHIELD	LITERAL2
INCLUDE_TOGGLE_BUTTON_SHIELD	LITERAL2
INCLUDE_GAMEPAD_SHIELD	LITERAL2
INCLUDE_PROXIMITY_SENSOR_SHIELD	LITERAL2
INCLUDE_MIC_SHIELD	LITERAL2
INCLUDE_TEMPERATURE_SENSOR_SHIELD	LITERAL2
INCLUDE_LIGHT_SENSOR_SHIELD	LITERAL2
INCLUDE_PRESSURE_SENSOR_SHIELD	LITERAL2
INCLUDE_GRAVITY_SENSOR_SHIELD	LITERAL2
INCLUDE_ACCELEROMETER_SENSOR_SHIELD	LITERAL2
INCLUDE_GYROSCOPE_SENSOR_SHIELD	LITERAL2
INCLUDE_ORIENTATION_SENSOR_SHIELD	LITERAL2
INCLUDE_MAGNETOMETER_SENSOR_SHIELD	LITERAL2
INCLUDE_PHONE_SHIELD	LITERAL2
INCLUDE_SMS_SHIELD	LITERAL2
INCLUDE_CLOCK_SHIELD	LITERAL2
INCLUDE_KEYBOARD_SHIELD	LITERAL2
INCLUDE_TWITTER_SHIELD	LITERAL2
INCLUDE_VOICE_RECOGNIZER_SHIELD	LITERAL2
INCLUDE_TERMINAL_SHIELD	LITERAL2
INCLUDE_FACEBOOK_SHIELD	LITERAL2
INCLUDE_NOTIFICATION_SHIELD	LITERAL2
INCLUDE_SEVEN_SEGMENT_SHIELD	LITERAL2
INCLUDE_SKYPE_SHIELD	LITERAL2
INCLUDE_MUSIC_PLAYER_SHIELD	LITERAL2
INCLUDE_EMAIL_SHIELD	LITERAL2
INCLUDE_FOURSQUARE_SHIELD	LITERAL2
INCLUDE_CAMERA_SHIELD	LITERAL2
INCLUDE_BUZZER_SHIELD	LITERAL2
INCLUDE_LED_SHIELD	LITERAL2
INCLUDE_LCD_SHIELD	LITERAL2
INCLUDE_TEXT_TO_SPEECH_SHIELD	LITERAL2
INCLUDE_DATA_LOGGER_SHIELD	LITERAL2
INCLUDE_PATTERN_SHIELD	LITERAL2
INCLUDE_INTERNET_SHIELD	LITERAL2
INCLUDE_COLOR_DETECTOR_SHIELD	LITERAL2
INCLUDE_NFC_SHIELD	LITERAL2
INCLUDE_GLCD_SHIELD	LITERAL2
CUSTOM_SETTINGS	LITERAL2
COLOR_UPPER_LEFT	LITERAL2	
COLOR_UPPER_MIDDLE	LITERAL2
COLOR_UPPER_RIGHT	LITERAL2
COLOR_CENTER_LEFT	LITERAL2	
COLOR_CENTER_MIDDLE	LITERAL2
COLOR_CENTER_RIGHT	LITERAL2
COLOR_LOWER_LEFT	LITERAL2
COLOR_LOWER_MIDDLE	LITERAL2
COLOR_LOWER_RIGHT	LITERAL2
MOST_DOMINANT_COLOR	LITERAL2
AVERAGE_COLOR	LITERAL2
SMALL_SIZE	LITERAL2
MEDIUM_SIZE	LITERAL2
LARGE_SIZE	LITERAL2
_1_BIT_GRAYSCALE_PALETTE	LITERAL2	
_2_BIT_GRAYSCALE_PALETTE	LITERAL2
_4_BIT_GRAYSCALE_PALETTE	LITERAL2
_8_BIT_GRAYSCALE_PALETTE	LITERAL2
_3_BIT_RGB_PALETTE	LITERAL2
_6_BIT_RGB_PALETTE	LITERAL2
_9_BIT_RGB_PALETTE	LITERAL2
_12_BIT_RGB_PALETTE	LITERAL2
_15_BIT_RGB_PALETTE	LITERAL2
_18_BIT_RGB_PALETTE	LITERAL2
_24_BIT_RGB_PALETTE	LITERAL2
TNF_UNKNOWN	LITERAL2
TNF_EMPTY	LITERAL2
TNF_EXTERNAL_TYPE	LITERAL2
TNF_MIME_MEDIA	LITERAL2
TNF_UNCHANGED	LITERAL2
TNF_ABSOLUTE_URI	LITERAL2
RTD_TEXT	LITERAL2
RTD_URI	LITERAL2
RTD_UNSUPPORTED	LITERAL2
TAG_NOT_SUPPORTED	LITERAL2
RECORD_CAN_NOT_BE_PARSED	LITERAL2
INDEX_OUT_OF_BOUNDS	LITERAL2
NO_ENOUGH_BYTES	LITERAL2
TAG_READING_ERROR	LITERAL2
RECORD_NOT_FOUND	LITERAL2
STYLE_2D	LITERAL2
STYLE_3D	LITERAL2
ARIAL	LITERAL2
ARIAL_BOLD	LITERAL2
ARIAL_ITALIC	LITERAL2
COMIC_SANS	LITERAL2
SERIF	LITERAL2
SMALL	LITERAL2
MEDIUM	LITERAL2
LARGE	LITERAL2
